1111111111111111111111111111111111111111111111111111111111111111111111111111111111111111111111111111
1000011111100000000000000000000000100000000000110000000000000111111111100000000000000000000000000001
1000000000100000000000000000000000100000000000110000000000000111111111100000000000000000000000000001
1000000000100000000000000001000000100000000000010000000000000000000000100000000000000000000000000001
1000000000100000000000000001000000100000000000000000000000000000000000000000001111111111000000000001
1000000000100000000000000001000000100000000111000000000000000000000000000000001000000000000000000001
1000000000100000000000000001000000100000000100000000000000000000000000000000001000000000000100000001
1000000001000000000000000001110000100000000100000000000000000000000000000000001000000000000110000001
1000000001111100000000000001110000100000000000000000000000000000000000000000001111111000000000000001
1000000001000000000000000011110000100000000000000000000000000000000000000000000000000000000000000001
1000000001000000000000000000000000100000000000001111000000000000000000000000000000000000000000000001
1000111111000000000000000000001111100000000000000001000000000000000000000000000000000000000000000001
1000000000000000000000000000010000000000000000000001000000000000100000000000000000000000000000000001
1000000000000000000000000000010000000000000000000001000000010000100000000000000000000000000000000001
1000000000001110000000000000111100000000000001100001000000010000100000000000000000000000001000000001
1000000000000000001111000000110000000000000001000001000111110000100000000000000000000000001000000001
1000000000000000000001000000110000000000000001000001001100000000100000000000000000000000001000000001
1000000000000000000001000000110000000000000001000001000000000011100000000000000000000000001000000001
1000111111100000000001000000110000000111111000000000000000000011100000000000000010000000001000000001
1000100000000000000001000000110000000000000000000000000000000011100000000000111110000000001111000001
1000100000000000000001000000000000000000000000000000000000000011100000000000000001000000000000000001
1000100000000000000001000000000000000000000000000000000000000011111111111000000001000000000000000001
1000000000000000000001000000000000000000000000000000000000000011111000000000000001000000000000000001
1000000000000000000001000000000000000000000000000000000000000011111000000000001111000000000000000001
1000000000000000000000000000000000000000000000000000000000000000001000000000000000000000000000000001
1000000000000000000000000000000000000001111111100000000000000000001000000000000000000000000000000001
1000000000000000000000000000000000000000000000100000000001100000001000000000000000000000000000000001
1000000000000111100000000000000000000000000000100000000000100000001000000000000000000000000000000001
1000000000000100000000000000000011111100000000111111000000100000001000000000000000000000000000000001
1000000000000100000000000000000000000000000000100001000000100000001111111111000000000000000000000001
1000011111111100000000000000000000000000000000000001000000100000000000000001000000000000000000000001
1000010000000100000000000000000000000000000000000001000000000000000000000001000000000000000000000001
1000000000000000000000000000000000000000000000000001000001000000010000000001000000000000000000000001
1000000000000000000000000000000000000000000000000001000001000000010000000001000000000000000000000001
1000000000000000000000000000000000000000000000000001000001000000010000000001000000000000000000000001
1000000000000000000000000000001001000000000000000001000001000000010000000001000000011111000000000001
1000000000000000000000000000001001000000000000000000000001111100010000000001000000010000000000000001
1000000000000000000000000000001001111110001110010000000000000000010000000001000000010000000000000001
1000000000000000000000000000001000000000001000010000000000000000010000000000000000010000000001111001
1000000000000000000000000000001000000000000000010000000000001111110000000000000000000000000000001001
1000000000000000000000000000001000000000000000010000000000000000011110000000000000000001100000001001
1000000111100000000000000000111000000000000000010000000000000000010000000000000010000001000000001001
1000000001111100000011111000000000011000000000010000000000000000010000000000000010000001000000001001
1000000000100100000000011000000000011000000000010000000000000000010001111100000011100011000000001001
1000000000000100000000011000000000011111000000010000000000000000010000000000000011100010000000001001
1000000000000100000000001000000000000001000000011111100000000000000000000000000011111110000000001001
1000000000000100000000000000000000000001000000000000000000000000000000000000000000000000000000001001
1000000000000100000000000000000000000001000000000000000000000000000000000000000000000000000000001001
1000000000000100000000000000000000000000011111100000000000000000000000000000000000000000000000001001
1000000000000111000000000000000001111110000000000000000000000000000000000000000000000000000000000001
1000000000000011000000000000000001000000000000000000000000000000000000000000000000000000000000000001
1000000000000011000000000000000001000000000000000100000000111111110001000000000000001111111100000001
1000000000000000000000111111110001000000000000000100000000000000011111000000000000000000000100000011
1001110000000000000000000000010000000000000000000100000000000000010000000000000000000000000100000011
1000001111111000000000000000010000000000000000000100000000000000010000000000000000000000000100000011
1000000000001000000000000000010000000000000000000100000000000000000000000000000000000000000100000011
1000000000001000000000000000010000000000000000000100000000000000000000000000000000000000000100000011
1000000000001000000000000000010000000000000011111100000000000000000000000000000000000000000100000011
1000000000001000000000000000011111100000000000000000000000000000000000111000000000000000000100000011
1000000000000000000000000000011111100000000000000000000000001111111110111000000000000000000100000011
1000000000000000000000000000011111100000000000000000000000001000000011111000000000000000000100000011
1000000000000000000000000000011111100000000010000000000000000000000010011000000000000001111100000011
1000000000000000000000000000011111111110000010000000000000000000000010011111111100011000000000000011
1000000000000001000000000000010000000000000010000000000000000000000000011000000000001000000000000011
1000000001111111000000000000010000000000000010000000000000000000000000001000000000000000000000000011
1000000000000000000000001111110000000000000010000000000000000000000000001000000000000000000000000011
1000000000000000000000001000000000000000000010000000000000000000000000000000000000000000000000000011
1000000000000000000000001000000000000000000011100000000000000000000000000000000000000000000000000011
1100000000000000000000001000000000000000000000000000000000000000000000000000000000000000000000000011
1100000000000000011111111000000000000000000000000000000000000000000000000000000000000000000000000011
1111000000000000000000000000000000000001111111000010000000000000000000000000000000000000000000000011
1000000000000000100000000000000000000000000001111110000000000100000000000010000000000000000111111111
1000000000000011100000000000000000000000000000000000000000000100000000000010000000000000000000001001
1001111111111111100000000000000000000000000000000000000000000100000000000111111000000000000000001001
1000000000000111110000001110000000000000000000000000000000000100000000000010000000000000000000001001
1000000000000100010000001000000000000111111000000000000000000110000000000010000000000000000000001001
1000000000000000010000001000000000000010000000000000000000000000000000100010000000000000000000001001
1000000000000000000000001000000000000010000000000000000000000000000000100011111110000000000000001001
1000000000000000000000000000000000000010000000000000000000000000000000100000000000000000000000001001
1000000000000000000000000000000000000010000000000000000000000001111111100000000000000000000000001001
1000000000000000000000000000000111111110000000000000010000000000000000000000000000000000000000000001
1111111111100000000000000000000000000000000000000000010000000000000000000000000000000000000000000001
1100000000000000000000000000000000000000000000000000010000000000000000000000000000000000000000000001
1000000000000000000000000000000000000000000000000000010000000000000000000000000000000000000000000001
1000000000000000000000000000000000000000000000000000010000000000000000000000000111111111000000000001
1000000000000000000000000000000000000000000000000111110000000000000000000000000100000000100000000001
1000000000000000000000000000000000000000000000000111111111111000000001110000000100000000100000000001
1000000000111100000000111111000000000000000001000000000000000000000110010000000100000000110000000001
1000000000000100000000100000000011111111111111000000000000000000000010000000001100000000111110000001
1000000000000000000000100000000000000000000000000000000000000000000000000000001100000000110000000001
1000000000000000000000000000000000000000000000000000000000001111100001111110001000000000000000000001
1000000000000000111110000000000000000000000000000000000000001000000001000000001000000000000000000001
1000000000000000100000000001111111000000000000000000000000000000000000000000001000000000000000000001
1000000000000000100000000001000000000000000000000000000000000000000000000000001000000000000000000001
1000000000000000100000000001000000000000000000000000000000000000000000000000001111110000000000000001
1000000000000000100000000001000000000000000000000000000000000000000000000000000000000000000000000001
1000000000000000100000000000000000000000000000000000000000000000000000000000000000000000000000000001
1000000000000000100000000000000000000000000000000000000000000000000000000000000000000000000000000001
1000000000000000100000000000000000000000000000000000000000000000000000000000000000000000000000000001
1111111111111111111111111111111111111111111111111111111111111111111111111111111111111111111111111111
