1111111111111111111111111111111111111111111111111111111111111111111111111111111111111111111111111111
1111111111100000000000001000000000000001111000000010000000000000000111111111100000000000000000000001
1110000000000000000000001000000000000001111000000010000000000000000100000000100000000000000000000001
1110000000000000000111111000000000000000001000000010000000000000000100000000100000000000000000000001
1110000000000000000000000000000000000000001000000010000000000000000100000000100000000000000001111111
1000000000000000000000000000000000000000001000000010000000000000000100000000100000000000000001111111
1000000000000000000000000000000000000000001000000011111111100000000100000000100000000000000001111111
1110000000000000000000000000000000000000001000000000000000000000000100000000000000000000000001111111
1110000000000000000000000000000000000001111111100000000000000000000100010000000000000000000001111111
1110000000000000001110000000000000000000000000100000000000000001111111110000000000000000000001111111
1110000000000000000010000000000000000000000000100000000000000000000100000000000000000000000001111111
1110000000000000000010000000000000000000000000100000000000000000000100000000000001111000000001111111
1110000000000000000011111111110000000000000000110000000000000000000100000000000000001000000001111111
1110000001100000000010000000010011111000000000000000000000000000000100000000000000001000000001111111
1000000000100000000010000000000000001000000000000000000000000000000111111111001110001000000001111111
1000000000100000000010000000000000000000000000000000000000000010000000000000000010001000000001111111
1000000000111111110010000000000000000000000000000000000000000010000000000000000000001000000001111111
1000000000111000000010000000000000000000000000000000000000000011111000000000000000001000000011111111
1000010000111000000010000000000000000000000000000000000000000000000000010000000000000000000011111111
1000010000111000000000000000000000000000000000000000000000000000000000010000000000000000000011111111
1000110000001000000000000001111110000000000000000000010000000000000000010000000000000100000000111111
1000000000001000000000000001110000000011111111111111110000000000001111111000000111111100000000111111
1000000000001000000000000001110000000000000000000000000000000000001000011000000000000000000000111111
1000000000000000000000000111110000000000000000000000000000000100000000011110000000000000000000111111
1000100000000000000000000000000000000000000000000000000000000100000111111000000000000000000000111111
1000111111100000000000000000000000000000000000000000000000000100000100000000001111100000000000111111
1000000000000000000000000000000000000000000000000000000000000100000100000000000000000000000000111111
1000000000000000000000000000000000000000000000000000001111111100000100000000000000000000000000111111
1000000000000000000000000000000000000000000000000000000000000000000100000000000000000000000000111111
1000000000000000000000010000000000000000000000000000000000000000011100000000000011111100000000111111
1000000000000000011110010000000000000000000000001100000000000000011100000000000000000100000000111111
1000000000000000011111111111000000000000000000001000000000000000000000000000000000000100000000111111
1000000000000000010000000000001000000000000000000000000000000000000000000000000000000000011111111111
1000000000000000010000000000001000000000000000000000000000000000000000000000000000000000010000111111
1000000000000000010000000000001000000111111111111000000000000000000000000000000000000000010000111111
1000000000000000010000000000011000000100000000000000000000000000000100000000000000000000010000111111
1000000000000000010000000000000000000100000000000000000000001111111100000000000001111000010000111111
1001110000000000010000000000000000000100000000000000000000000000000000000001000001000000010000111111
1001000000000000000000000000000000000100000000000000000000000000000000000001000001000000010000111111
1001000001110000000000000000000011110000000000000000000000000000000000000001000001111000010000111111
1001000001000000000000000000000010000000000000000000000000000000000000000001000000001000010000111111
1001110001000000110000000000000110000000000000000000000000000000000000000011000000001000010000111111
1000010001000000010000000000000010000000000000000000000000000000000000000000000000001000000000111111
1000010001000000010000011110000010000000000000000000000000000000000000000000011110000000000000111111
1000010001000000010000010000000000000000000000000000000000000000000011000000010000000000000000111111
1000010000000000010000000000000000000000000000000100011111110000000001000000000000000000000000111111
1000010000000000000000000000000000000000000000000100000000010000000001000000000000100000000000111111
1000010000000000000000000000000000000000000000001100000000000000000001000000000000100000000000111111
1000000000000000000000000000000000000100000000000100000000000000000011111000001111100000000000111111
1000000000000000000000000000000111111100000000000100000100000000000001001000000000000011110000111111
1000000000000001000000000000000111111100000000001100000100000000000001000000000000000000000000001001
1000000000000001111000000000000111111100000000000000000100000000000000000011111000000000000000001001
1000000000000000000000000000000000000000000000000000000100000000000000000000001000011110000000001001
1000000000000000000000011111000000000000000000000000000100000000000000000000000000000000000000001001
1000000000000000000000000001000000000000000000000000000100000000000000000000000000000000000000001001
1000000000000000000000000001000000000000000000000000000100000000000000000000000000000000000000001001
1000000000000000000000000001000000000000000000001111111100000000000000000000000000000000000000001001
1000000000000000000000000000000000000000000000000000000000000000000000011100000000000000000000001001
1000000000001111111111110000000000000000000000000000000000000000000000000100000000000000000000001001
1000000000001000000000000000000000000000000000001000000000000000000000000000000000000000010000001001
1000000000001000000000000000000000010000000100001000000000000011111000000000000000111100010000001001
1000000000001000000000000000011100011111111100001000000000000010000000000001111100100000010000001001
1111111000000000000000000000000100000000000111111000000000000010000000000001000000000011110000001001
1110000000000000000000000000000000000000000100001000000001111110000000000001000000000000000100001001
1110000011110000000000000000000000100000000100001000000001000010000000000000000000000000000100001001
1110000010000000000000000000000000100000000100001000000001000010000000000000000000000000000100001001
1110000010000000000000000000000000100000000100001000000001000000000000000000000000000000000100001001
1000000010000000000000000000000000110000000100001000000000000000000000000000000000000000000100001001
1000000010000000000000000000000000000011111100001000000000000000000000000000000000000001000100001001
1000000000000000000000000000000000000010000100001111110000000000000000000000000000000001000100001001
1110000000000000000000000010000000000000000000000000000000000000000000001000000000000001000100001001
1110000000000000000000000010000000000000000000000000000000000000000000001000000000000001000111001001
1110000000000000000000000010000000000000000000000000000000000000000000001111111000000001110000001001
1111100000000000000000000010000000000000000000000000000000000000000000000000000000000001000000011001
1000000000000000000000000010000000000000000000000000000000000000000000000000000000000001000000000001
1000000000000000000111111110000000000000000000000000000000000000000010000000000000000001000000000001
1000000000000000000001111111111110000000000000000000000000000000000010000000000000000001100100000001
1000010000000000000001000000000000000000000000000000000000000000000010000000000000001111100100110001
1000010000000000000001000000000000000000000000011100000000000000000010000000011111111000000111100001
1000011111111100000001000000000000001100000011100000000000000000000010000000010000000000000000000001
1000000000100000000001000000000000001000000000100000000000000000000010000000000000000000000000000001
1000000000100000000001000000000000001000000000000011111111111110011110000000000000000000000000000001
1000000000100000000001000000000000001000000000000010000000000000000000000000000000000000000000000001
1000000000111111100001000000000000000000000000000010000000000000000000000000000000000000000000000001
1000000000100000000001000000000000000000000000000010000000000000000000000000000000000000000000000001
1000000000100000000000000000000000000000000001111110000000000000000000000000000000000000000000000001
1000000000000000000000000000000000000000000000000000000000000011000000000000000000000000000000000001
1000000000000000111100000000000000000000000000000000000000000001000000000010000000000000000000100001
1000100000000000100000000000000000000000000000000000000000000001000000000010000000000011110000111111
1000100000000000100000000000000000000000000000000001111000000001000000000010000000000000010000000001
1111111111000000100000000000000000000000001000000000001000000000000000000011111000010000010000000001
1100000000000000100000000000000000000000001000000000001000000000000000000010000000010000010000000001
1000000000000000100000000000000000000000001110000000001000000000000000000010000001110000010000000001
1000000000000000000000000000000000000000000000000000001001000000000000000010000000000000010000000001
1000000000000000000000000000000000000000000000000000001001000000000000000010000000000000000000000001
1000000000000000000000000000000000000000000000000000001001000000000000000110000000000000000000000001
1000000000111000000000000000000000000000000000100000000001000000000000000000000000000000000000100001
1000000000111100000000000000000000000000000000111000000001000000000000000000000000000000000000100001
1000000000111111100000000000000000000000000000111000011111000000000000000000000000000000011111100001
1111111111111111111111111111111111111111111111111111111111111111111111111111111111111111111111111111
