1111111111111111111111111111111111111111111111111111111111111111111111111111111111111111111111111111
1001000000000000000000000000011111111100000000000000000000000000000111000000000000000000000000000111
1001000000000000000000000000011111111100000000000000000000000000000001000000000000000000000000000111
1001000000000000000000000000000000000000000000000000000000000000000001000000000000000000000000011111
1001000000000000000000000000000000000000000000000000000000000111110000000000000000000000000000011111
1001000000001100000000000000000000000001000000000000000000000000000000000000000000000000000000011111
1001000000000100000000000000000000000011000000000000000000100000000000000000000000000000000000011111
1001000000000100000000000000000000000000000000000000001111100000000000000010000000000000000000011111
1001000000000100000000000000000000000000000000000000000000000000000000000011100011110000000000011111
1001000000000100000000000000000011100000000111110000000000000000000000000011100010000000000000011111
1001110000000100000000000000000010000000000000000000000000000000000000000011111110000000000000011111
1000010000000100000000000000000010000000000000000000000000000000000000000010000010000000000000011111
1000010000000100000000000000000010000000000000000000000000000000001111111110000010000000000000011111
1000010000000100000000000000000000000000000000000000000000000000000000000000000010000000000000011111
1000010000000100000000000000000000000000000000000000000000000000000000000000000010000000000000011111
1000011111100100000000000001110000000000000000000010000000000000000000000000000010000000000000011111
1000000000000100000000000000010000000000000011111110000000000000000000000000000000000000000000011111
1000000000000100010000000000010000000000010000000001111111000000000000000000000000000000000001111111
1000000010000001111111111110010000000001111000000000000000000000000000000000000000000000000000011111
1000000011110001000000000000000000000000001000000000000000000000000000000000000000000000000000011111
1000000000000001000000000000000000000000001000000000000000000000000000000000000000000010000000011111
1000000000000001000000000000000000000000000000000000000000001000000000000000111111000110000000011111
1000000000000000000000000000000000000000000000000111111111001000000001100000100000000111111111111111
1000000000000000000000000000000000000000000000000000000001001000000000100000000000000100000000111111
1000000000000000000000000000000000000000000000000000000001001000000000100000000000000100000000111111
1000000000000000000000000000000000100000000000000000000001111000000000100000000000000100000000111111
1000000000001000000000000000010000100000000000000000000000001000000000100000011111111100000000111111
1000000000001110000000000000010000100000000000000000000000001111000000000000010000000000000000111111
1000000000000100000000000000010000110000000000000000000000001000001110000000010000000000000000111111
1000000000000100000000000000010000000000000000000000000000001000000000000000010000000000000011111111
1000000000000100000000000000011100000000000000000000000000001000000000000000010000000000000011111111
1000000000000100000000000000000000000000000000000000000001111000000111110000010000000000000000011111
1000000000000100000000000000000000000000000000000000000000000000000100000000010000000000000000011111
1000000000000111110000000000000000000000000000000000000000000000000100000111110000000000000000011111
1111111100000000001111111000000000000000000000000000000000001110001100000100001111111111000000011111
1111100100000000000000001000000000000000000000000000000000001000000000000100000000000111000000011111
1000100000000000000000001000000000000000000000000000000000001000000000000100000000000111000000011111
1000100000000000000000000000000100000000000000000000000000001000000000000100000000000111000000011111
1000100000000000000000000000000100000000011111110000000000000000000000000000000000000111000000011111
1000100000000000000000000000000100000000010000000000000000000000000000000000000000000011000000011111
1000100000000000000000000000000100000000010000000000000000000000000000000000000000000011000000011111
1000111111000000000000000000000100000000010000000000000000000000000000000000000000000000000000011111
1000100000000000000000000000000111000000000000000000000000000100000001111111000000000000000000011111
1000100000000000000000111111000000000000000000000000000000000100000000000001000000001111100000011111
1000000000000000000000100000000000000000000000000000000000100111100000000000000000001000000000011111
1000000000000000000000100000000000000000000000000000000011100000000000000000000000001000000000011111
1000000001110000000000100000000000000000000000000000000011100000000000000000000000001000000000011111
1000000000110000000000100000000000000000100001100000011111110000000000000000000000001000000000011111
1000000000110000000000000000000000000000100001000000000011110000000000111110000000111000000000011111
1000000000110000000000000000000010000000100001000000000011110000111111111110000000100000000000011111
1000001111110000000000000000000010000000100001000000000011110000000000001110000000100000000000011111
1000000000010000000000000000000011111111111001000000000000010000000000001111111110000000000000011111
1000000000010000000000000000000000000000000001000000000000010000000000000010000000000000000000011111
1000000000010000000000000000000000000000000001000000000011110000000000000010000000000000000000011111
1000000000000000000000011111111111000000000000000000000000000000000000000000000000000000000000011111
1000000000000000000000010000000000000000000000000000000000000000000000000000000000000000000011111111
1000000000000000000000010000000000000000000000000000000000000000000000000000000000000000000000011111
1000000000000000000000010000000000000000000000000000000000000000000000000000000000000000000000011111
1000000000000000000000010000000000000000000000000000000000000000000000000000000000000000000000011111
1000111110000000000000010000000001100000000000000000000000000000000000000000000000000000000000011111
1000100000000000000000011111111000000000000000000000000000000000000000000000111110000000000000011111
1000100000000000000000000000000000000000000000000000000000000011111000000000100000000000000000011111
1000000000000000000000000000000000111111100000000000000000000000000000000000000000000000000000011111
1000000000111111110000000000000000100000000000000000001000000000000000000000000000000000000000011111
1110000000000000010000000000000000100000000000000000001000000000000000000000000000000000000000011111
1111000000000000010000000000000000100000000000000000001000000000000000000000000000000000000000011111
1001110000000000010000000000000000100000000000000000001000000000000000000000000000000000011111111111
1000010000000000010000000000000000100000000000000000001000000000000000000000000000000001000000011111
1000010000000000000000000000000000100000000000001111111000000000000000000000000001111111000000011111
1000010000000000000000000000010000100000000000000000000000000000000000001111000001111111000000011111
1000010000000000000000000000010000100000000000000000000000000000000000001000000011111111000000011111
1000000000000000000000000000010000100000000000000100000000000000000000001000000010000000000000011111
1000000000001000000000000000010000100000000000000100000000000000000000001000000010000000000000011111
1000000000001000000000000000010000100000000000000100000000000000000000000000000010000000000000011111
1000000000001000000000000000011111111100000000000100000000000000000000000000000010000000000000011111
1000000000001000000000000011111111100100000000000100000000000000001100000000000010000000000000011111
1000000000001000000000000010000000100100000000000111000000000000000000000000000000000000000000011111
1000000000001000000000000010000000100111110000011111000000000000000000000000000000000000000000011111
1000000000001000000000000000000000000000000000000001000000000000000000000000000000000000000000011111
1000000000001000000000000000000000000000000000000001000000000000000000000000000000000000000000011111
1000000000001000000000000000000000000000000000000001000000000000000000000000000000000000000000011111
1000000000111111000000000000000000000000000000000001000000000000000000000000000000000000000000000001
1000000000100000000000000000000000000000000000000001000000000000000000000000000000000011111111000001
1000000000100000000000000000000000000000000000111111000111000000000001111000000000000010000000000001
1000000000100000000000000000000000000000000000111110000001000000010001000000000000000010000000000001
1000000011100000000000000000011111111111111111111110000001000000010001000000000000000010000000011111
1000000000000000000001000000000000000100000011000000000001000000011110000000000000000010000000011111
1100000000000111111111000000000000000100000011000000000000000111110000000000000000000011111111111111
1100000000000000000000000000000000000000000011000000000000000000000000000010000000000000000001111111
1100000000000000000000000000000000000000000011000000000000000000000000000010000000100000000001111111
1100000000000000000000000000000000000000000000000000000000000000000000000011111100100000000001111111
1100000000000000000000000000000000000000000000000000000000000000000000000000000000100000000001111111
1111111000000000000000000000000000000000000000000000001100000001111111000000000000100000000001111111
1000000000001111100000000000000000000000000000000000000000000000000001000000000000100000000001111111
1000000000000000100000000000000000010000000000000000000000000000000000000000000000100000000001111111
1000000000010000100000000000000000010000000000000000000000000010000000000000000000100000000001111111
1000000000010000000000000000000000011111111100000000000000111110000000000000000000100000000000011111
1000000000011000000000000000000000000000000000000000000000111110000000000000000111100000000000011111
1000000000011000000000000000000000000000000000000000000000111111111110000000000111100000000000011111
1111111111111111111111111111111111111111111111111111111111111111111111111111111111111111111111111111
