1111111111111111111111111111111111111111111111111111111111111111111111111111111111111111111111111111
1000000010001111110000000000000100001100000000000000000000000000000000000000000011110000000000000001
1000000000001111111100000000000000111111000000000000000000000000000000111000000011110000000000000001
1000000000001111111100000000000001111111000000000000000000000000000000000000000011110000000000000001
1000000000001111111100000000000001111111000000000000000000000000000000000000000011110110000000000001
1000000000001111111100000000000001111111000000000000000000000000000000000000000000000110000000000001
1000000000001111111100000000000001111111000000000000000000000000000000000000000000001110000000000001
1000000000000000000000000000000001111111000000000000000000110000000000000000000011101110011000000001
1000000000000000000000000000000000000000000000000000000000110000000000000000000000001110011000000001
1000000000000000000000000000000000000000000000000000000000000000000000000000000011111110000000000001
1000000000000000011000000000000000000000000000000000000000000000000000000000000011111110000000000001
1000000000000000011000000000000000000000000000000000000000000000000000000001110011111110000000000001
1000000000000000000000000000000000000000000000000000000001110000000000000011110011111110000000000001
1000000000000000000000000000000000000000000000000000000001110000110000000011110000000000000000000001
1000000001000000000000000000000000000000000000000000000001110000110000000011111110000000000000000001
1000000001000000000000000000000000000000000000000000000001110000000000000111111110111000000000000001
1000000000000000000001111000000000000000000000000000000000000000000000000111111110111001100000000001
1000000000000000000001111000000000000000000000000000000000000000000000000111111110000001100000000001
1000000000000000000001111000000000000000000000000000000000000000000000000111111110000001110000000001
1000000000000000000001111000000000000000000000000000000000011100000000000111111110000001110000000001
1000000000000000000000000000000000000000000000000000000000000000000000000111111110000001110000000001
1000000000000000000000000000000000000000000000000000000000000000000000000111111110000000000000000001
1000000000000000000000000000000000000000000000000000000000000001111100000000000000000000000000001111
1000000000000000000000000000000011000000000000000000000000000001111100000000000000111100000000000001
1000000000000000000000000000000111000000000000000000000011000001111100000000000000111100000000100001
1000000000000000111000000000000111000000000000000000000011111000000000000000111100111100111000100001
1000000000000001111000000000000111000000000000000000000011111001100000000000111110000000111000100001
1000000000000001111000000001100111000000000000000000000011111001100000000000111111000000111000000001
1100000000000000000011100001111111000000000000000000000000000000000000111000111111000000111000000001
1000000000000000000011100001111111000000000000000000000000000000000000111000111111000000000000000001
1000000000000000000111100001111111000000000000000000000000000000000000000000000000000000000000000001
1001000000000000000111100001111111000000001111000000000000000000000000000000000000000000001110000001
1001000000000000000111100001111111000000001111000000000000000000000000000000000111000000000000000001
1001000000000000000000000001111111000000001111000000000000000000000000000000000111000000000000000001
1000000001110000000000000000000000000000001111000000000000000000000000000000000111000000000000000001
1000000001110000000000000000000000000000000000000000000000111110000000000000000000000000000000000001
1000000000000000000000000000000000000000000000000000000000111110000000000000000000000000000000000001
1000000000000000000000000000000000000000000000000000111100111110000000000000000000000000000000000001
1000000000000000000000000000000000000000000000000001111111111110000000000000000000000000000000000001
1000000000000000000000000000000000000000000000000001111111111110000000000000000000000000000000000001
1000001111000000000000000000000000000000000000000001111111111110000000000000000000000011110000000001
1000001111000000000000000000000000000000000000000001111111111110000000000000000000000111111000000001
1011101111000000000000000000000000000000000000000001111111111111111110000000000000000111111000000001
1011100000000000000000000000000000000000000000000001111111111111111110000000000000000111111000000001
1011100000000000000000000000000000000000000000000001111111111111111110000000000000000111111000000001
1000000000000000000000000000000000000000000000000001111111111111111110000000000000000000000000000001
1000000000000010000000000000000000000000000110000001111111111111111110000000000000000000000000000001
1000000000000010000000000000000000000000000110000001111111111111111110000000000000001100000000000001
1000000000000010000000000000000000000000000000000001111111111111111110000000000000001100000000000001
1000000001111000000000000000000000000000000000000000000000000000000000000000000000000000000000001111
1000000001111000111000000000000000000000000000000000000000000000000000000000000000000000000000001111
1000000001111000000000000000000000000000000000000000000000000000000000000000000000000000000011100001
1000000000000010000000011100000000000000000000000000000001100000000000011000000000000000000011100011
1000000000000010000000011100000000000000000000000000000001100000000000011000000000000000000011100001
1000000000000010000000011100000000000000000000000000000000000000000000000000000000000000000000000001
1000000000000000000000000000000000000000000000000000000000000000000000000000000000000000000000001001
1000000000000000000000000000000000000000000000000000000000000000000000000000000000000000000110111001
1000000000000000000000000000000000000000000000000000000000000000000000000000000000000000000110111001
1000000000000000000000000110000010000000000000000000000000000000000000000000000000000000000000000001
1000000000000000000000000110000010000000000000000000000000000000000000000000000000000000000000000001
1000000000000000000000000000000010000000000000110000000000000000000000000000000000010000000000000001
1000000000000000000000000000000000000000000000110000000000000000000000000000000000010000000000000001
1000000000000000000000000000000000000000000000000000000000000000000000000000000000010000000000000001
1000000000000000000000000000000000000000000000000000000000000000000000000000000000000000000000000001
1000000000000000000000000000000000000000000000000000000000000000000000000000000000000000000000000001
1000011000000000000000000000000000000000000000000110000000100000000000011100000000000000000000000001
1100011000000000000000001110000000000000000000000110000000100000110000000000000000000000000000001111
1100000000000000000000001110000000000000000000000000000000100000110000000000000000000000000000001111
1000000000000000000000001110000000000000000000000000000000000000000000000000000000000000000000001111
1000000000000000000000001111111100000000000000000000000000000000000000001100000000000000000001111111
1000000000000111110000001111111111100000000000000000000000000000000000001100000000000000000011111111
1000000000000111110000001111111111101100000000000000000000000000000000000000000000000000000011111111
1000000000000000000000001111111111101100000010000000000000000000000000000000000000000000000011111111
1000000000110000000110001111111111101100000010000000000000000000000000000000111100000000000011111111
1000000000110000000110001111111111100000000010000000000000000000000000000000111100000000000011111111
1000001111111000000111001111111111100000000000000000000000000000000000000000111100000000000011111111
1000011111111111111111001111111111111100000000000000000000000000000000000000111100000000000000000001
1000011111111111111111001111111111111100011000000000000000000000000000011110000000000000000000000001
1111111111111111111111001111111111111100011000000000000000000000000000011110000000000000000000000001
1111111111111111111111001111111111111100000000000000000000000000000000011110000000000000000000000001
1111111111111111111111000000000000000000000000000000000000000000000000011110000000000000000000000001
1111111111111111111111000000000111100000000000000000000000000000000000000000000000000000000000000001
1111111111111111111111000000000111100000000000000000000000000000000000000000000000000011111000000111
1000000000000000000000000000000111100000000000000000000000000000000000000000000000000011111100000001
1001100000000000000000000000000000000000000000000000000000000000000000000000011100000111111100000001
1001100000000000000000000000000000000000000000000000000000000000000000000000000000000111111110000001
1000000000000001000000000000000000000000000000000000000000000000000000000001000000001111111111000001
1000000000000000000000000000000000000000000000000000000000000000000000000001000000011111111111000001
1000000000000000000111000000000000000000000000000000000000000000000000000001000000011111111111000001
1000000000000000000111000000000000000000000000000000000000000000000000000000000000011111111111000001
1000000000000000110111000000000000000000000000000000000001110000000000000000000000011111111111000001
1000000000000001110000000000111000000000000000000000000011110000000000000000000000011111111111000001
1000000000000011111111000000111000000000000000000000000011110000000000000000000000011111111111000001
1000000000000011111111000000111000000000000000000000000011110000000000000000000000011111111111000001
1000000000000000000000000000111000000000000000000000000000000000000000000000000000011111111111011101
1000000000000000000011100000000000000000000000000000000000000000000000000000000000000000000000011101
1000000000000100000011100000000000000000000000000000000000000000000000111000000000000000001100000001
1000000011110001100011100000000000000000000000000000000000000000000000000000000000000000001111000001
1000000011111111100011100000000000000000000000000000000000000000000010000000000000000000001111000001
1111111111111111111111111111111111111111111111111111111111111111111111111111111111111111111111111111
