1111111111111111111111111111111111111111111111111111111111111111111111111111111111111111111111111111
1000000000000000000000000000000000011000000000000000000000000000001100000000000000000000000000000001
1000000000000000000000000000000000011000000000110000000000000000001100000000000000000000111000000001
1000000000000000011100000000000000000000000000110000000000000111100000110000000000000000111000000001
1000000000000000011100000000000000000000000000000000000000000111100000110000110000000000111001111001
1000000000000110011100000000000000000000000000000000000000000111100000000000110000000000000001111001
1000000000000110000000000000000000111100000000000000000000000000000000000000000000000000000001111001
1000000000001111100000000000000000111100000000000000000000000000000000000000000000000000000001111001
1000000000001111100000000000000000111100011110000000000011100000000000000000000000000000110000000001
1000000000001111100000000000000000111100011110000000000011100000000000000000000000000000110000000001
1000000000001111100000000000000000000000011110000000000011100000000000000000000000000000000000000001
1000000000000000000000000000000000000000000000000000000011100000000000000000000000011000000000000001
1000000000000000000001110000000000000000000000000000000000000000110000000000000000011000000000001111
1000000000000000000001110000000000011100011100000000000000000000110000000000000000000000000000001111
1000000000000000000001110000000000011100011100000000000000000000000000000000000000000000000000001111
1000000000000000000000000000000001111101111100000000000000000000000000000000000000000000000000001111
1010000010000000000000000000000011111101111100000000000000000000000000111100000000111100000000000001
1010000010000000000000000000000111111101111100000000000000000000000000111100000000111100000000000001
1000000000000000000000000000000111111101111100000000000000000000000000111100000000111100100000000001
1000111000000000000000000000000111111101111100000000000000000000000000111100000000000000100000000001
1000000000000000000000000000000111111101111100000000000000000000000000000000000000000000100000000001
1000000000000000000000000000000111111101111100000000000001110000000000000000000000000000000000000001
1000000000000000000000000000000111111101111100000000000011111000011100000000000000000000000000000001
1000000000000000000000000000000111111100000000000000000011111000011100011100000000000000000000000001
1000000000000000000000000000000111111100000000000001000000000000011100011100000000000000000000000001
1000000000000000000000000000000111111100000000000001000000000000011100011100000000000000000000000001
1000000001110000000000000000000111111100000000000001100000000000000000000000000000111001000000000001
1000000011110000000000000000000000000000000000000011100000000000000000000000000000000001000000000001
1000110011110000000000000000000000000000000000000011100000110000000000000000000000000001000000000001
1000110011110000000000000000000000000000000000000011100000110000000000000000000000000000000000000001
1000000000000000000000000000000000000000000000111111100000000000000000000000000000000000000000011101
1000000000000000000000000000000000000000000000111111110000000000000000000000000000000000000000011101
1000000000000000000000000000000000000000000000111111111000000000000000000000000000000000000000000001
1000000000000000000000000000000000000000000000111111111000101000000000000000000000000000000000011111
1000000000000000000000000000000000000000000000111111111000000001110000000000000000000000000000011111
1000000000000000000000000000000000000000000000111111111000000000000000000000000000000000000000011111
1011100000000000000000000000000000000000000000111111111000000000000000000000000000000000000000011111
1011100000000000000000000000000000000000000000111111111000000000000000000000000000000000000000011111
1000000000000000000000000000000000000001100000111111111000000000000000000000000000000000000000011111
1011110000000000000000000000000000000001100000111111111000000000000000000000000000000000000000011111
1011110000000000000000000000000000000000000000000000000000000000000000000000000000000000000000000001
1000000000000000000000111110000000000000000000000000000000000000000000000000000000000000000000000001
1100110000000000000001111110000000000000000000000000000000000000000000000000000000000000000000000001
1100110000000000000001111110000000000000000000000000000000000000000000000000000000000000000000000001
1000000000000000000001111111110000000000000000000000000000000000000000000000000000000000000000000001
1000001100000000000001111111111111100000000000000000000000000000000000000000000000000000000000000001
1000001100000000000111111111111111100000000000000000000000000000000000000000000000000000000000000001
1000000000000000001111111111111111100000000011111000000000000000000000000000000000000000000000000001
1000000000000000001111111111111111100000000011111000000000000000000000000000000000000000000000000001
1000000000000000111111111111111111100000000111111000000000000000000000000000000000000000000000000001
1000000000000000111111111111111111100000000111111000000000000000000001100000000000000000000000000001
1000000000000000111111111111111111100000000111111000000000000000000001100000000000000000000000011001
1000000000000000111111111111111111100000000111111000000000000000000000000000000000000000000000011001
1000000000000000000000000000000000000000000111111000000000000000000000000000000000000000000000000001
1000000000000001110000000000000000000000000000000000000000000000000000000000000000000000000000000001
1000000000000000000000000000000000000000000000000000000000000000000000000000000000000000000000000001
1000000000000000000000000000000111100000000000000000000000000000000000000000000000000000000000000001
1000000000000000001110000000000111100000000000000001111000000000000000000000000000000110000000000001
1000000000000000001110000000000111100000000000000001111000000000000000000000000000000110000000000001
1000000000000000000000000000000111100000000000000001111000000000000000000000000000000000000000000001
1000000000000000000000000000000000000000000000000001111000000000000000000000111000000000000000000001
1000000000000000000000000000000000000000000000000000000000000000000000000001111000000000000000000111
1000000000000000111100000011111000000000000000000111111000111000000000001111111000000000000000000111
1000000000000001111100000011111000000000000000001111111000111100001100011111111000000000011000000111
1000000000000001111100000011111000000000000000001111111011111111111100011111111000000000011000000001
1000000000000001111100000011111000000000000000001111111011111111111110011111111000000000000000000001
1000000000000001111100000000000000000000000000001111111011111111111110011111111000000000000000000001
1000000000000001111100001100000000000000000000000000000011111111111110000000000000000000000000000111
1000000000000001111100001100000000000000000000000000000011111111111110000000000000000000000000000111
1000000000000000000000000000000000000000000000000000001111111111111110000000000000000000000000000111
1000000000000000000000000000000000000000000000000000111111111111111110000000000000000000000000000111
1100000000000000000000000000000000000000000000000001111111111111111110000000000000000000000000010111
1100000000000000000000000000000000000000000000000011111111111111111110000000000000000000110000010001
1000000000000000000000000000000000000000000000000011111111111111111110000000000000000000110000010001
1000000000000000000000000000000000001110000000000011111111111111111110000000000000000000000000000001
1000000000000000000000000000000000001110000000000011111111111111111110000000001111110000000000000001
1000000000110001100000000000000000001110000000110011111111111111111110000000011111110000000000000001
1000000000110001100000000000000000000000000001110000000000000000000000000000011111110000000000000001
1000000000000000000000000000000000000000000001110000000000000000000000000000011111110000000000000001
1000000000000000000000011111100000000000000000000001111000000000000000000000011111110000000000000001
1000000000000000000000011111100000000000000000111001111000000000000000000000011111110000000000000001
1000000000000000000000011111111110000000000000111000000011100000000000000000011111110000000000000001
1000000000000000000000011111111110000000000000111001100011110000000000000000000000000000000000000001
1000000000000000000000011111111110000000000000111000000011110000000000000000000000000000000000000001
1000000000000000000000011111111110000000000000000000111111111000000000000000000111000000000000000001
1000000000000000000000011111111110000000000000000000111111111000000000111000000111000000000000000001
1000000000000000000000011111111110000000000000000000111111111000000000111100000111000000000000000001
1000000000000000000000011111111110000000000000000000111111111011100011111100000000000000000000000001
1000000000000000000000011111111110000000110011100000000000000011110011111100000000000000000000000001
1000000000000000000000000000000000000000110000000000000000000011110000000000000000000000000000000001
1000000000000000000001110000000000000000000000000000000000000011110001100000000000000000000000000001
1000000000000000000001111110000000000000000000000000000000000011110000000000000000000000000000000101
1000000000000000000001111110000000000000000000000000000000000000000000000000000000000000000000000101
1000000000000000000001111110000000000000000000000000000000000000000000000000000000000000000000000101
1000000000000000000001111110000000000000000000000000000000000000000000000000000000000000000000000001
1000000000000000000011111110000000000000000000000000000000000000000000000000000000000000000000000001
1000000000000001110011111110000000000000000000000000000000000000000000000000000000000000000000000001
1000000000000001110011111110000000000000000011100000000000000000000000000000000000000000000000000001
1000000000000001110000000000000000000000000011100000000000000000000000000000000000000000000000000001
1111111111111111111111111111111111111111111111111111111111111111111111111111111111111111111111111111
