1111111111111111111111111111111111111111111111111111111111111111111111111111111111111111111111111111
1000000000000000000000000000000000000000000000000000001000000000000000000000000000000000000000000001
1000000000000000000000000000000000000000000000000000000000000000000000000000000000000000000000000001
1000000000000000000000000000000000000000000000000000000000110000000000000000000000000000000000000001
1000000000000000000000000000000000000000000000000000000000110000000000000000000000000000000000000001
1000000000000000000000000000000000000011000000000000000000000000000000000000000000000000000000000001
1000000000000000000000000000000000000011000000000000000000000000000000000000000000000000000000000001
1000000000000000000000000000000000000000000000000000000000000000000000000000000000000001100000000001
1000000000000000000000000000000000000000000000000000000000000000000000000000000000000001100000000001
1000000000000000000000000000000000000000000000000000011000000000000000000000000000000000000000000001
1000000000000000000000000000000000000000000000000000011000000000000000000000000000000000000000000001
1000000000000000000000000000000000000000000110000000000000000000000000000000000000000000000000000001
1000000000000000000000000000000000000000000110000000000000000000000000000000000000000000000000000001
1000000000000001111000000000000000000000000110000000000000000000000000000000000000000000000000000001
1000000000000001111100000000000000000000000111000000000000000000000000000000000000000000000000000001
1000000000000001111100000000000000000000000111000000000000000000000000000000000000000000000000000001
1000000000000001111100000000000000000000001111000000000010000000000000000000000000000000000000000001
1000000000000001111100001110000000000000001111100000000010000000000000000000000000000000000000000001
1000000000000000000000001110000000000000001111100000000010000000000000000000000000000000000000000001
1000000000000000000000001110000011000001111111100000000000000000000000000000000000000000000000000001
1000000000000111100000000000000011000001111111100000000000000000000000000000000000000000000000000001
1000000000000111100000000000000000000001111111100110000000000000000000000000000000000000000000000001
1000000000000111100000000000000000000000000000000110000000000000000000000000000000000000001110000001
1000000000110000001000000000000000000000000000000000000000000000000000000000000000000000001110000001
1000000000110000001100000000000000000000000000000011000000000000000000000000000000000000001110000001
1000000000000011111110000000000000000000000000000011000000000000000000000000000000000000000000000001
1000000000000111111110000000000000000000000000001011000000111110000000000000001111000000000000000001
1000000000000111111110000000000000000000000000001011000000111110000000000000001111000000000000000001
1000000000000111111110000000000000000000000000000000000000111110000000000000001111000000000000000001
1000000000000111111110001111110000000000000000000000000000000000000000000000001111000000000000000001
1000000000001111111110011111110000000000000000000000000000000001100000000000000000000000000000000001
1000000000001111111110011111111110000000000000000000000000111001100000000000000000000000000000000001
1000000000101111111110011111111110000000111100000000000000111001100000000000000000000000000000000001
1000000000101111111110011111111110000000111100000000010100111000000000000000000000000000000000000001
1001110000101111111110011111111110000000111100000000000110000000000000000000000000000000000000000001
1000000000001111111110011111111110000000111100000001000110001110000000000000000000000000000000000001
1100000100001111111111111111111110000000000000000001010000001110000000000000000000000000000000000001
1100000100001111111111111111111110000000000000000000000001100000000000000000000000000000000000000001
1100000100001111111111111111111110000000000000000000000000000001100000000000000000000000000000000001
1000000000001111111111111111111110000000000000000000000000000001100000000000000011000000000000000001
1001110000001111111111111111111110000000000000000000000000000000000000000000000011000000000111100001
1000000000001111111111111111111111011010000000000000000000000000000000000000000000000000000111100001
1000000000001111111111111111111111011011000000000000000000000000000000000000000000000000000111100001
1000000000001111111111111111111111000011000000000000000000000000000000000000000000000000000000000001
1000000000001111111111111111111111111111000111000000000000100000000000110000000000000000000000000001
1000000000001111111111111111111111111111000111000000000000100000000000110000000000000000000000000001
1000000000001111111111111111111111111111000111000000000000100000000000000000000000000000000000000001
1000000011001111111111111111111111111111000000000000000000000000000000000000000000000000000000000001
1000000011111111111111111111111111111111100000000000001110001110000000000000000000000000000000000001
1000000011111111111111111111111111111111110000000000000000000000000000000000000000000000000000000001
1000000111111111111111111111111111111111110000000000000000100000000000000000000000000000010000000001
1000000111111111111111111111111111111111110000000000000000100000000000000000000000000000010000000001
1000000111111111111111111111111111111111110001110000000000100000000000000000000000000000010000001111
1000000111111111111111111111111111111111110001110000000000000000000000000000000000000000000000001111
1000000111111111111111111111111111111111110001110000000000000000000000000000000000000000000000001111
1000000111111111111111111111111111111111110000000000000000000000000000000000000000000000000000000001
1000000000000000000000000000000000000000000000000000000000000000000000000000000000000000000000000001
1000000000000000000000000000000000000000000000000000000000000000000000000011000000000000000000000001
1000000000000011110000000000000000000000000000000000000000000000000000000011000000000000000000000001
1000000000000011110000000000000000000000000000000000100000000001110000000000000000000000000000000001
1000000000000011110000000000000000000000000000000000100000000000000000000000000000000000000000000111
1000000000000000000000000000000000000000000000000000100000000100000100000000000000000000000011000111
1000000000000000000000000000000000000000000000000000000000000100000100000000000000000000000011000111
1000000000000000000000000000000000000000000000000000000000000100000100000000000000000000000000000111
1000000000000000000000000000000000000000000000000000000000000000000000000000000000000000000000000001
1000000000000000000000000000000000000111000000000000000000000000000000000000000000000000000000000001
1000000000000000000000000000000000000000000000000000000000000000001110000000000000000000000000000001
1000000000000000000000000000000000010000010000000000000000000000001110000000000110000000000000000001
1000000000000000000000000000000000010000010000000000000000000000001110000000000110000000000000000001
1000000000000000000000000000000000010000010000000000000000011100001110000000000000000000000000000001
1000000000110000000000000000000000000000000000000000000000000000000000000000000000000000000000000001
1000000000110000000000000000000000000111000000000000000000000000000000000001100000000000000000000001
1000000000000000000000000000000000000000000000000000000000000000000000000001100000000000000000000001
1000000000000000000000000000000000000000000000000000000000000000000000000000000000000000000000000001
1000000000000000000000000000000000000000000000000000000000000000111000000000000000000000000000000001
1000000011100000000000000000000001100000000000000000000000000000111000000000000000011100000000000001
1000000011100000000011110000000001100000000000000000000000000000111000000000000000011100000000000001
1000000011100000000011110000000000000000000000000000000000000000111000000000000000011100000000000001
1000000000000000000011110000000000000000000000000000000000000000000000000000000000000000000000000001
1000011100111000000000000000000000000000000000000000000000000000000000000000000000000000000000000001
1000011111111000001110000000000000000000000000000000000000000000000000000000000000000000000000000001
1000011111111000001111000000000000000000000000000000000000000111000000000000000000000000000000000001
1000011111111000001111000000000111110000000000000000000000000111000000000000000000000000000000000001
1000000000000000001111000011111111110000000000000000000000000111000000000000000000000000000000000001
1000000000000000000000000011111111110000000000000000000000000000000000000000000000000001100000000001
1000000000000000000000000011111111110000000000000000000000000000000000000000000000000001100000000001
1000000000000000000000000011111111110000000000000000000001100000000000000000000000000000000000000001
1001100000000000000000000000000000000000000000000000000011110000000000000000000000000000000000000001
1001100000000000000000000000000000000000000000000000000011110000000000000000000000000000000000000001
1000000000000000000000000000000000000000011100000000000000000000000000000000000000000001110000000001
1000000000000000000000000000000000000000111110000110000100000000000000000000000000000000000000000001
1000000000000000000000000000110000000001111110000110000000000000000000000000000000000000000000000001
1000000000000000010000000000110000000001111110000000000000000000000000000000000000000000000000000001
1000000000000000010000000000000000000001111110000000000000000000000000000000000000000000000000000001
1000000000000000010000000000000000000001111110000000000000000000000000000000000000000000000000000001
1000000000000000000000000000000000000001111110000000000000000000000000000000000000000000000000000001
1000000000000000000000000000011000000001111110000000000001100000000000000000000000000000000000000001
1000000000000000000000000000011000000001111110000000000001100000000000000000000000000000000000000001
1000100000000000000000000000000000000001111110000000001000000011000000000000000000000000000000000001
1111111111111111111111111111111111111111111111111111111111111111111111111111111111111111111111111111
