1111111111111111111111111111111111111111111111111111111111111111111111111111111111111111111111111111
1000000000000000000000000000000000000000000000000000000000000000000000000000000000000000000000000001
1000000000000000100010010001001000100111110010001001111100100010010001001111100111110010001001111101
1000000000000000100010010001001000100100010010001001000100100010010001001000000100010010001001000101
1000000000000000100010010001001000100100010010001001000100100010010001001000000100010010001001000101
1000000000000000100010010001001000100100010010001001000100100010010001001000000100010010001001000101
1000000000000000111110011111001111100100010011111001000100111110011111001111100100010011111001000101
1000000000000000000000000000000000000000000000000000000000000000000000000000000000000000000000000001
1000000000000000000000000000000000000000000000000000000000000000000000000000000000000000000000000001
1000000000000000111110011111001000100100010010001001000100111110011111001111100100010011111001000101
1000000000000000100000010000001000100100010010001001000100100010010001000000100100010010001001000101
1000000000000000100000010000001000100100010010001001000100100010010001000000100100010010001001000101
1000000000000000100000010000001000100100010010001001000100100010010001000000100100010010001001000101
1000000000000000111110011111001111100111110011111001111100100010010001001111100111110010001001111101
1000000000000000000000000000000000000000000000000000000000000000000000000000000000000000000000000001
1000000000000000000000000000000000000000000000000000000000000000000000000000000000000000000000000001
1010001001111100111110011111001111100111110011111001111100111110010001001111100111110011111001111101
1010001001000100100000010000001000000100010010001001000100100000010001001000100000010010000000000101
1010001001000100100000010000001000000100010010001001000100100000010001001000100000010010000000000101
1010001001000100100000010000001000000100010010001001000100100000010001001000100000010010000000000101
1011111001000100111110011111001111100100010010001001000100111110011111001000100111110011111001111101
1000000000000000000000000000000000000000000000000000000000000000000000000000000000000000000000000001
1000000000000000000000000000000000000000000000000000000000000000000000000000000000000000000000000001
1011111001111100111110010001001111100111110011111001000100111110011111001111100111110011111001111101
1010000000000100100000010001001000000000010010000001000100100010010000001000100100000000001000000101
1010000000000100100000010001001000000000010010000001000100100010010000001000100100000000001000000101
1010000000000100100000010001001000000000010010000001000100100010010000001000100100000000001000000101
1011111001111100111110011111001111100111110011111001111100100010011111001000100111110011111001111101
1000000000000000000000000000000000000000000000000000000000000000000000000000000000000000000000000001
1000000000000000000000000000000000000000000000000000000000000000000000000000000000000000000000000001
1010001001111100111110011111001111100111110011111001111100111110010001001111100100010011111001000101
1010001000000100000010000001001000000100010010001000000100000010010001001000000100010010000001000101
1010001000000100000010000001001000000100010010001000000100000010010001001000000100010010000001000101
1010001000000100000010000001001000000100010010001000000100000010010001001000000100010010000001000101
1011111001111100111110011111001111100100010010001001111100111110011111001111100111110011111001111101
1000000000000000000000000000000000000000000000000000000000000000000000000000000000000000000000000001
1000000000000000000000000000000000000000000000000000000000000000000000000000000000000000000000000001
1011111001111100100010011111001111100111110011111001111100111110011111001111100111110011111001111101
1010001001000100100010010000000000100000010000001001000000100000000001000000100000010010000001000101
1010001001000100100010010000000000100000010000001001000000100000000001000000100000010010000001000101
1010001001000100100010010000000000100000010000001001000000100000000001000000100000010010000001000101
1010001001000100111110011111001111100111110011111001111100111110011111001111100111110011111001000101
1000000000000000000000000000000000000000000000000000000000000000000000000000000000000000000000000001
1000000000000000000000000000000000000000000000000000000000000000000000000000000000000000000000000001
1011111001111100111110010001001111100111110011111001111100111110011111001111100100010011111001000101
1010001001000000100010010001001000100000010010001000000100100000010001001000100100010010001001000101
1010001001000000100010010001001000100000010010001000000100100000010001001000100100010010001001000101
1010001001000000100010010001001000100000010010001000000100100000010001001000100100010010001001000101
1010001001111100100010011111001000100111110010001001111100111110010001001000100111110010001001111101
1000000000000000000000000000000000000000000000000000000000000000000000000000000000000000000000000001
1000000000000000000000000000000000000000000000000000000000000000000000000000000000000000000000000001
1010001001111100100010011111001111100111110011111001111100111110011111001000100111110011111001111101
1010001001000100100010010000001000100100000010001001000000100010010001001000100100000010000001000001
1010001001000100100010010000001000100100000010001001000000100010010001001000100100000010000001000001
1010001001000100100010010000001000100100000010001001000000100010010001001000100100000010000001000001
1011111001000100111110011111001000100111110010001001111100100010010001001111100111110011111001111101
1000000000000000000000000000000000000000000000000000000000000000000000000000000000000000000000000001
1000000000000000000000000000000000000000000000000000000000000000000000000000000000000000000000000001
1011111001111100111110010001001000100100010011111001111100111110011111001111100111110010001001111101
1010000001000100100010010001001000100100010010001000000100100000010000001000000100010010001000000101
1010000001000100100010010001001000100100010010001000000100100000010000001000000100010010001000000101
1010000001000100100010010001001000100100010010001000000100100000010000001000000100010010001000000101
1011111001000100100010011111001111100111110010001001111100111110011111001111100100010011111001111101
1000000000000000000000000000000000000000000000000000000000000000000000000000000000000000000000000001
1000000000000000000000000000000000000000000000000000000000000000000000000000000000000000000000000001
1011111001111100111110010001001111100111110011111001111100111110010001001111100111110011111001000101
1010000001000100100000010001001000000000010010001001000100000010010001000000100100000000001001000101
1010000001000100100000010001001000000000010010001001000100000010010001000000100100000000001001000101
1010000001000100100000010001001000000000010010001001000100000010010001000000100100000000001001000101
1011111001000100111110011111001111100111110010001001000100111110011111001111100111110011111001111101
1000000000000000000000000000000000000000000000000000000000000000000000000000000000000000000000000001
1000000000000000000000000000000000000000000000000000000000000000000000000000000000000000000000000001
1011111001111100100010011111001000100111110010001001111100111110011111001111100100010011111001111101
1010000001000000100010000001001000100000010010001000000100000010010000001000100100010000001000000101
1010000001000000100010000001001000100000010010001000000100000010010000001000100100010000001000000101
1010000001000000100010000001001000100000010010001000000100000010010000001000100100010000001000000101
1011111001111100111110011111001111100111110011111001111100111110011111001000100111110011111001111101
1000000000000000000000000000000000000000000000000000000000000000000000000000000000000000000000000001
1000000000000000000000000000000000000000000000000000000000000000000000000000000000000000000000000001
1011111001111100111110011111001111100100010011111001000100111110011111001111100111110011111001111101
1010001001000100100000010000000000100100010010001001000100000010010001001000100000010000001001000001
1010001001000100100000010000000000100100010010001001000100000010010001001000100000010000001001000001
1010001001000100100000010000000000100100010010001001000100000010010001001000100000010000001001000001
1010001001000100111110011111001111100111110010001001111100111110010001001000100111110011111001111101
1000000000000000000000000000000000000000000000000000000000000000000000000000000000000000000000000001
1000000000000000000000000000000000000000000000000000000000000000000000000000000000000000000000000001
1011111001111100100010010001001111100100010011111001111100111110011111001111100111110010001001111101
1010001001000100100010010001000000100100010010000001000100000010000001000000100100000010001001000001
1010001001000100100010010001000000100100010010000001000100000010000001000000100100000010001001000001
1010001001000100100010010001000000100100010010000001000100000010000001000000100100000010001001000001
1010001001000100111110011111001111100111110011111001000100111110011111001111100111110011111001111101
1000000000000000000000000000000000000000000000000000000000000000000000000000000000000000000000000001
1000000000000000000000000000000000000000000000000000000000000000000000000000000000000000000000000001
1011111001111100100010011111001111100100010011111001111100111110011111001111100111110011111001111101
1010000000000100100010000001001000000100010010001000000100000010010000000000100100000000001001000101
1010000000000100100010000001001000000100010010001000000100000010010000000000100100000000001001000101
1010000000000100100010000001001000000100010010001000000100000010010000000000100100000000001001000101
1011111001111100111110011111001111100111110010001001111100111110011111001111100111110011111001000101
1000000000000000000000000000000000000000000000000000000000000000000000000000000000000000000000000001
1111111111111111111111111111111111111111111111111111111111111111111111111111111111111111111111111111
